X X X X X X X X X X
X O O O O O O O 2 X
X O O O O O O O O X
X O O X X X X O O X
X O O X X X X O O X
X O O X X X X O O X
X O O X X X X O O X
X O O O O O O O O X
X 1 O O O O O O O X
X X X X X X X X X X