X X X X X X X X X X
X O O O O X X X 2 X
X O X X O X X X O X
X O X X O X X X O X
X O X X O O O O O X
X O X X X X X X X X
X O O O O O O O O X
X X X X X X X X O X
X 1 O O O O O O O X
X X X X X X X X X X